Admission Exam:
Vitals-   98.4, 122 / 81, 101, 20, 95 ra 
General: Well-appearing female in no apparent distress
HEENT: Sclera anicteric, extraocular movements intact, 
oropharynx
with moist mucous membranes no petechiae,  no mucositis, no wet
purpura
Chest: A few scattered petechiae over her R neck and upper back
CARDIAC: RRR, nml S1 and S2, no m/r/g
LUNGS: Clear to auscultation bilaterally w/appropriate breath
sounds appreciated in all fields.  No w/r/r
ABDOMEN:  soft, obese, somewhat distended, nontender, +bs
GU: no Foley
EXTREMITIES: wwp, +distal pulses
SKIN: no other petechial lesions except of R neck and upper back
NEUROLOGIC: AOx3, moving all extremities purposefully, grossly
nonfocal

Discharge Exam:
Vitals: 98.1, 104/71, 84, 18, 95%RA
Gen: NAD, lying in bed, pleasant
Eyes: EOMI, sclera anicteric  
ENT: MMM, OP clear
Cardiovasc: RRR, no MRG, full pulses, no edema  
Resp: normal effort, no accessory muscle use, lungs CTA ___.
GI: soft, NT, ND, BS+
MSK: No significant kyphosis. No palpable synovitis.
Skin: A few scattered petechie over her R neck and upper back. 
No
jaundice.
Neuro: AAOx3. No facial droop.
Psych: Full range of affect