>> Admission Physical Exam: 
 VITALS: 98.2, 142/75, 71, 17, 99%RA  
 GENERAL: Pleasant, well-appearing, in no apparent distress.  
 HEENT - normocephalic, atraumatic, no conjunctival pallor or 
scleral icterus, PERRLA, EOMI, OP clear.  
 NECK: Supple, no LAD, no thyromegaly, JVP flat.  
 CARDIAC: RRR, normal S1/S2, no murmurs rubs or gallops.  
 PULMONARY: Clear to auscultation bilaterally, without wheezes 
or rhonchi.  
 ABDOMEN: Normal bowel sounds, soft, non-tender, non-distended, 
no organomegaly.  
 EXTREMITIES: Warm, well-perfused, no cyanosis, clubbing or 
edema.  
 SKIN: Without rash or ecchymoses.  
 NEUROLOGIC: A&Ox3, CN II-XII grossly normal, normal sensation, 
with strength ___ throughout.  
 RECTAL: deferred by patient  
.
>> Discharge Physical Exam: 
Vitals: 98.2   ___   79  18  100 RA
General: Alert, oriented, no acute distress. 
HEENT: Sclera anicteric, MMM, oropharynx is clear. 
Neck: Supple, No cervical LAD. 
Lungs: Clear to auscultation bilaterally, no adventitial sounds 
heard. 
CV: RRR, S1, S2. no extra sounds. 
Abdomen: Soft, NT/ND. BS+. There is no tenderness. 
Extremities: Warm, well perfused 2+ peripheral pulses. No ___ 
edema. 
Neuro: CN II-XII intact, grossly normal.