General: NAD. Well-nourished, well-developed. Appears very
well-groomed with styled hair and glasses.
HEENT: Normocephalic, atraumatic. PERRL, EOMI. Oropharynx clear.
Neck: Supple.
Back: No significant deformity.
Lungs: CTA ___. No crackles, wheezes, or rhonchi.
CV: RRR, no murmurs/rubs/gallops. 
Abdomen: +BS, soft, nontender, nondistended. No palpable masses
or organomegaly.
Extremities: No clubbing, cyanosis, or edema.
Skin: No rashes, abrasions, scars, or lesions. 

NEUROLOGIC EXAMINATION:
Cranial Nerves:
-Pupils symmetry and responsiveness to light and accommodation:
PERRLA
-Visual fields: full
-EOM: full
-Facial sensation to light touch in all 3 divisions: intact
-Facial symmetry on eye closure and smile: intact & symmetric
-Hearing bilaterally to rubbing fingers: intact
-Phonation: normal
-Shoulder shrug & head turn: normal bilaterally
-Tongue: midline, no atrophy
Motor: Normal bulk and tone bilaterally. No abnormal movements,
no tremor. 
Strength: full power ___ throughout. 
Coordination: Able to manipulate objects across midline.
Sensation: Intact to light touch throughout. 
Gait: Steady. Normal stance and posture. No truncal ataxia.

COGNITIVE EXAM: 
- Wakefulness/alertness: awake and alert
- Attention: MOYB intact
- Orientation: oriented to person, time, place, situation
- Executive function (go-no go, Luria, trails, FAS): not tested
- Memory: intact to recent and past history
- Fund of knowledge: consistent with education
- Calculations: correctly states 7 quarters in $1.75
- Abstraction: apple/orange = "fruit"
- Visuospatial: not assessed
- Speech: normal rate, volume, and tone
- Language: native ___ speaker, no paraphasic errors,
appropriate to conversation

MENTAL STATUS EXAM:
- Appearance: No apparent distress, appears stated age,
- Behavior: Calm, cooperative, appropriate eye
contact, no psychomotor agitation or retardation
- Mood and Affect: "fine I guess" / euthymic, full range,
appropriate to situation, congruent with mood
- Thought Process: linear, coherent, goal-oriented. No LOA.
- Thought Content: denying active and passive SI currently.
Denies HI and AVH.
- Judgment and Insight: impaired/impaired

Discharge Examination: 
98.2  99/63  70  18  100%RA 
A/B: Appears stated age, dressed casually with excellent hygiene 
and grooming, calm, cooperative with interviewer, good eye 
contact, no psychomotor agitation or retardation noted
S: normal rate, volume, prosody 
M: "good" 
A: slightly anxious, mood congruent, appropriate
TC: denies SI/HI, AVH
TP: linear, goal and future oriented
C: awake, alert and oriented x3 
I/J: fair/fair