Admission exam:
VITALS: 98.1 PO 134/65 L Sitting 68 18 99 Ra 
GENERAL: Alert and in no apparent distress
EYES: Anicteric, pupils equally round
ENT: Ears and nose without visible erythema, masses, or trauma. 
Mucous membranes moist with no lesion or erythema of the
oropharynx
CV: Heart regular, no murmur
RESP: Lungs clear to auscultation with good air movement
bilaterally
GI: Abdomen soft, non-distended, non-tender to palpation
MSK: Neck supple, moves all extremities, strength grossly full
and symmetric bilaterally in all limbs
GU: no palpable inguinal lymph nodes
SKIN: Diffusely affecting the upper and lower extremities, large
erythematous patches with some crusting, maculopapular erythema
of the posterior back
NEURO: Alert, oriented, face symmetric, gaze conjugate with 
EOMI,
speech fluent, moves all limbs
PSYCH: pleasant, appropriate affect

Discharge exam:
VS: T 97.7, HR 65, BP 125/71, RR 18, SpO2 98% on RA
Gen: NAD, breathing room air comfortably
HEENT: mmm, OP clear
Pulm: CTAB
CV: NR/RR, no m/r/g
Abd: Soft, ND, NTTP, normoactive bowel sounds
Ext: No ___ edema, 2+ DP pulses b/l
Skin: Erythematous maculpapular patches with scaling and 
crusting involving the truck, upper back, and upper and lower 
extremities
Neuro: alert, oriented x3, face midline, MAE spontaneously
Psych: normal affect