Neurological:
 Cranial Nerves:
  - Unable to perform given dysregulation.  

- Motor: Normal bulk and tone bilaterally. No abnormal  
movements, no tremor. 
- Strength: Moves upper and lower extremities antigravity and 
with full ROM. 
- DTRs: Not assessed. 
- Sensation: Unable to perform given dysregulation.   
- Gait: Steady. Normal stance and posture. No truncal ataxia.

Cognition: 
- Wakefulness/alertness: awake and alert
- Attention: Distracted, unable to maintain attention to 
complete full psychiatric interview/exam
- Orientation: oriented to person, time, place, situation
- Memory: intact to recent and past history
- Fund of knowledge: Unable to perform given dysregulation.  
- Calculations: Unable to perform given dysregulation.  
- Abstraction: Unable to perform given dysregulation.  
- Visuospatial: Unable to perform given dysregulation.  
- Speech: Rapid rate, loud
- Language: native ___ speaker, no paraphasic errors

Mental Status:
- Appearance: Appears stated age, hygiene appropriate
- Behavior: Uncooperative, hostile toward this interviewer and 
RN; yells, uses frequent profanity
- Mood and Affect: "frustrated"; affect labile, hostile
- Thought Process: Circumstantial, periods of linearity
- Thought Content: Denies SI
- Judgment and Insight: poor/poor