ADMISSION PHYSICAL EXAM:  
=============================
VITALS: Reviewed in metavision 
GENERAL: Anxious, tearful appearing woman in no acute distress 
HEENT: Sclera anicteric, MMM, oropharynx clear  
NECK: JVP not elevated, full ROM without rigidity 
LUNGS: Clear to auscultation bilaterally, no wheezes, rales, 
rhonchi  
CV: tachycardia, no murmurs
ABD: soft, non-tender, non-distended, bowel sounds present, no 
rebound tenderness or guarding
EXT: Warm, well perfused, 2+ pulses, no clubbing, cyanosis or 
edema  
SKIN: Diaphoretic, flushed without ulcers or injury  
NEURO: AAOx3, endorses auditory and visual hallucination, no 
focal deficits
ACCESS: peripheral

DISCHARGE PHYSICAL EXAM:
=============================
-Vitals: reviewed in OMR
-General: NAD, alert and interactive 
-HENT: atraumatic, normocephalic, moist mucus membranes 
-Eyes: PERRL, EOMi
-Cardiovascular: RRR, no murmur 
-Pulmonary: clear b/l, no wheeze 
-GI: Soft, nontender, nondistended, bowel sounds present
-GU: no foley, no CVA/suprapubic tenderness 
-MSK: No pedal edema, no joint swelling 
-Skin: No rashes, ulcerations, or jaundice
-Neuro: AAOx3, no focal neurological deficits, CN ___ grossly 
intact 
-Psychiatric: overall depressed mood with appropriate affect