VS: T:97.8   BP:122/86 HR:88 RR:20 O2:99 
 General: NAD
 HEENT: PERRL, MMM, OP clear.
 Neck: Supple. No adenopathy or thyromegaly.
 Back: No significant deformity, no focal tenderness
 Lungs: CTAB; no crackles or wheezes.
 CV: RRR; no m/r/g
 Abdomen: Soft, NT, ND.
 Extremities: No clubbing, cyanosis, or edema.
 Skin: Warm and dry, no rash or significant lesions.
Neuro-
CN: 
      pupils symmetry and responsiveness to light and
accommodation: pupils symmetric and responsive to light and
accommodation
     EOM: intact
     tongue: midline, no atrophy
Motor: strength grossly intact, lifts self up onto exam table
DTRs: patellar reflexes 1+ b/l
Sensation: grossly intact
Gait: normal gait

Neuropsychiatric Examination:
MENTAL STATUS EXAM:
-Appearance: Well groomed woman who appears stated age,
 sitting up in chair, in no acute distress, wearing hospital
 gown.
-Behavior: Calm and cooperative with interview, very poor eye
 contact, forthcoming, slightly restless, answers questions
appropriately. Not responding to internal stimuli
-Speech: abundant speech, not pressured, normal rate/rhythm/tone
-Mood and Affect: "a little nervous", affect congruent and with
normal range
-Thought process: circumstantial, at times tangential
-Thought Content: rumination over medical problems, passive SI,
denies SI with a plan/HI/AVH
-Judgment and Insight: poor/fair
  
 COGNITIVE EXAM:
 Orientation: alert to person, place, time, situation
 Attention/concentration: grossly intact
 Memory: long term memory intact, short term memory grossly
intact
 Language: fluent, ___
 Fund of knowledge: not assessed