Admission physical exam:
VITALS: Afebrile and vital signs stable (see eFlowsheet)
GENERAL: Alert and in no apparent distress
EYES: Anicteric, pupils equally round
ENT: Ears and nose without visible erythema, masses, or trauma. 
Oropharynx without visible lesion, erythema or exudate
CV: Heart regular, no murmur, no S3, no S4.  No JVD.
RESP: Lungs clear to auscultation with good air movement
bilaterally.  Breathing is non-labored
GI: Abdomen soft, non-distended, non-tender to palpation.  Bowel
sounds present.  No HSM
GU: No suprapubic fullness or tenderness to palpation
MSK: Neck supple, moves all extremities, strength grossly full
and symmetric bilaterally in all limbs
SKIN: No rashes or ulcerations noted
NEURO: Alert, oriented, face symmetric, gaze conjugate with 
EOMI,
speech fluent, moves all limbs, sensation to light touch grossly
intact throughout
PSYCH: pleasant, appropriate affect

Discharge physical exam
T98.4, BP 143/100, HR 98, RR 18, O2 97% RA
Gen - NAD, sitting up in bed, comfortable appearing
HEENT - nc/at, moist mucous membranes
Eyes - anicteric, perrl
Neck - supple, no lad
___ - rrr, s1/2, no m/r/g
Pulm - CTA b/l, no w/r/r
GI - soft, NT, ND, +bowel sounds, negative ___ sign, no 
rebound/guarding/rigidity
Ext - no peripheral edema
Skin - warm, dry, no rash
Psych - calm, appropriate
Neuro - non focal, moving all extremities