Admission physical exam
VS: Afebrile and vital signs stable (reviewed in bedside record)
General Appearance: pleasant, comfortable, no acute distress
Eyes: PERLL, EOMI, no conjuctival injection, anicteric
ENT: no sinus tenderness, MMM, oropharynx without exudate or
lesions, no supraclavicular or cervical lymphadenopathy, no JVD,
no carotid bruits, no thyromegaly or palpable thyroid nodules
Respiratory: CTA b/l with good air movement throughout
Cardiovascular: RR, S1 and S2 wnl, no murmurs, rubs or gallops
Gastrointestinal: nd, +b/s, soft, nt, no masses or HSM
Extremities: no cyanosis, clubbing or edema
Skin: warm, no rashes/no jaundice/no skin ulcerations noted
Neurological: Alert, oriented to self, time, date, reason for
hospitalization.  
Psychiatric: pleasant, appropriate affect
GU: no catheter in place

Discharge physical exam 
T 98.1 PO, 131/71, 57, 20, 95 Ra 
Gen - no distress, well appearing, resting comfortably in bed 
HEENT - nc/at, moist mucous membranes, no tenderness over 
sinuses, erythema and pustules in posterior pharynx, slightly 
improved compared to prior, airway patent 
Eyes - anicteric, perrl
Neck - supple, no LAD appreciated, no palpable swelling 
___ - RRR, s1/2, no murmurs
Pulm - CTA b/l, no w/r/r
GI - soft, nt, nd, +BS
Ext - no peripheral edema
Skin - warm, dry, no rashes 
Psych - calm, cooperative
Neuro - non focal, aaox3, speech clear and coherent