VS: BP:145/79   HR:85   temp:98.4    resp:18  O2 sat:99%RA 

General: Young adult male in NAD. ___, 
___.
Appears stated age.
 HEENT: Normocephalic, atraumatic. PERRL, EOMI. Oropharynx 
clear.
 Neck: Supple.
 Back: No significant deformity.
 Lungs: CTA ___. No crackles, wheezes, or rhonchi.
 CV: RRR, no murmurs/rubs/gallops. 
 Abdomen: +BS, soft, nontender, nondistended. No palpable masses
or organomegaly.
 Extremities: No clubbing, cyanosis, or edema.
 Skin: No rashes, abrasions, scars, or lesions. 

Neurological:
 Cranial Nerves:
 -Pupils symmetry and responsiveness to light and accommodation:
PERRLA
 -Visual fields: full to confrontation
 -EOM: full
 -Facial sensation to light touch in all 3 divisions: equal
 -Vacial symmetry on eye closure and smile: symmetric
 -Hearing bilaterally to rubbing fingers: normal
 -Phonation: normal
 -Shoulder shrug: intact
 -Tongue: midline

Motor: Normal bulk and tone bilaterally. No abnormal movements,
no tremor. Strength: full power ___ throughout. Coordination:
Normal on finger to nose test. DTRs: 2+ and symmetrical
throughout. Sensation: Intact to light touch throughout. 
 Gait: Steady. Normal stance and posture. No truncal ataxia.
 Romberg: Negative.

Cognition: 
 Wakefulness/alertness: awake and alert
 Attention: intact to interview
 Orientation: oriented to person, time, place, situation
 Executive function ___ go, Luria, trails, FAS): not tested
 Memory: intact to recent and past history
 Fund of knowledge: consistent with education
 Calculations: not assessed
 Abstraction: not assessed
 Visuospatial: not assessed
 Speech: normal rate, volume, and tone
 Language: native ___ speaker, no paraphasic errors,
appropriate to conversation