Social History
Marital status:     Single                                      
Children:           No                                          
Lives with:         Other: roomates                             
Lives in:           House                                       
Work: ___
Multiple partners:  ___                                      
___ activity:    Past                                        
Sexual orientation: Male and Female                             
Sexual Abuse:       Denies                                      
Domestic violence:  Denies                                      
Contraception:      Condoms - Male                              
Tobacco use:        Never smoker                                
Alcohol use:        Past and Present                            
drinks per week:    4                                           
Depression:         Based on a PHQ-2 evaluation, the patient    
                    does not report symptoms of depression      
Exercise:           Activities                                  
Diet:               healthy diet
Family History
Relative Status   Age Problem              Onset Comments       
Mother   Living   ___  CELIAC DISEASE             colitis too    
                      HYPOTHYROIDISM                            
Father   Living   ___                                            
Sister   Living   ___                                            
Sister   Living   ___                                            
Brother  Living   ___    
 
Physical Exam:
Admission:
Gen - non-toxic appearing, overall weak, NAD
Eyes - anicteric
ENT - dry MMM
Heart - RRR, no r/m/g
Lungs - nonlabored breathing, CTAB
Abd - soft ntnd
Ext - no pedal edema
Skin - no skin rashes
Vasc - WWP
Neuro - A&Ox4, motor and sensory exam grossly normal
Psych - pleasant, calm cooperative