ADMISSION PHYSICAL EXAM:  
VS: T 99.3 HR 101 BP 113/66 RR 18 SAT  96% O2 on RA
GENERAL: Very pleasant and well appearing ___ speaking woman
in no distress. 
EYES: Anicteric sclerea, PERLL, EOMI; 
ENT: Oropharynx clear without lesion, JVD not elevated 
CARDIOVASCULAR: Regular rate and rhythm, no murmurs, rubs, or
gallops
RESPIRATORY: Appears in no respiratory distress, clear to
auscultation bilaterally, no crackles, wheezes, or rhonchi
GASTROINTESTINAL: Normal bowel sounds; nondistended; soft,
nontender without rebound or guarding; no hepatomegaly, no
splenomegaly
MUSKULOSKELATAL: Warm, well perfused extremities without lower
extremity edema; Normal bulk 
NEURO: Alert, oriented, CN III-XII intact, motor and sensory
function grossly intact
SKIN: No significant rashes
LYMPHATIC: No cervical, supraclavicular, submandibular
lymphadenopathy. No significant ecchymoses

DISCHARGE EXAM:
98.8 112/71 94 20 97 RA 
GEN: Pleasant female in NAD
HEENT: MMM, no TTP over anterior sinuses, no cervical adenopathy
CV: RRR no murmurs
RESP: CTAB no w/r
ABD: soft, NT, ND, NABS
GU: no foley
EXTR: warm, no edema
DERM: no appreciated rash
NEURO: alert, appropriate, ambulating in room independently