PRE-OPERATIVE PHYSICAL EXAM:

GENERAL:  No acute distress, well developed, well nourished,
appears younger than stated age.
HEENT: NC/AT, sclera anicteric
SKIN:  Warm and dry.
NEUROLOGIC:  Alert and oriented x 4.
NECK: Supple no mass
LYMPHATICS:  No palpable supraclavicular, cervical, or
inguinofemoral lymphadenopathy.
LUNGS:  Clear to auscultation bilaterally.
HEART:  Regular rate and rhythm.
BACK: No spinal or cva tenderness.
ABDOMEN:  Soft, obese, midline incision with hernia, nontender,
nondistended, without palpable masses or
EXTREMITIES:  Nontender, no edema bilaterally.
PELVIC:  
-External female genitalia: normal
-Vagina: no lesions
-Cervix: no lesions, not expanded
-Uterus: not enlarged, nontender
-Adnexa: no palpable masses
RECTAL:  deferred

PHYSICAL EXAM ON DISCHARGE:
Afebrile, vitals stable
No acute distress
CV: regular rate and rhythm
Pulm: clear to auscultation bilaterally
Abd: soft, appropriately tender, nondistended, incision 
clean/dry/intact, no rebound/guarding
___: nontender, nonedematous