Exam:
  *VS:  BP: 94/57  HR:67  temp: 98.0 PO resp: 16  O2 sat:99

General: Well-nourished, well-developed. Appears stated age.
* HEENT: Normocephalic. PERRL, EOMI. 
* Neck: Supple, trachea midline.
* Back: No significant deformity. No focal tenderness.
* Lungs: Clear to auscultation bilaterally. 
* CV: Regular rate and rhythm. No murmurs/rubs/gallops. 
* Abdomen: Soft, nontender, nondistended
* Extremities: No clubbing, cyanosis, or edema.
* Skin: Warm and dry. No readily apparent rashes, scars, or
lesions.

  Neurological:
    *station and gait: normal
    *tone and strength: grossly intact, anti-gravity
  *Appearance: pt appears stated age, wearing heavy coat, dark
jeans as per previous days
  Behavior: mildly irritable but cooperative
  *Mood and Affect: "better" affect anxious but with fuller 
range
  *Thought process (including whether linear, tangential,
circumstantial and presence or absence of loose *associations):
linear and goal directed w/o LOA
  *Thought Content (including presence or absence of
hallucinations, delusions, homicidal and suicidal ideation, with
details if present): denies hallucinations, denies current
suicidal ideation 
  *Judgment and Insight: good/fair
  Cognition:
    *Attention, *orientation, and executive function: attentive
to interview, oriented to self and situation
    *Memory: intact to recent events
    *Fund of knowledge: average
    *Speech: low volume, normal rate, rhythm and prosody 
    *Language: Fluent ___ w/o paraphasic errors