Physical Examination:
Vitals BP 136/81 HR 95 98% Sp02 RR 16 T 98.1

General: Age-appropriate, in a hospital gown.
Skin: Several superficial horizontal cuts along anterior aspect
of left forearm. No visible rashes.
HEENT: PERRL 4 -> 3. EOM grossly intact. Oropharynx without
lesions, erythema, or exudates.
Lungs: CTAB, no wheezes, normal work of breathing.
CV: RRR, no murmurs, rubs, or gallops.
Abdomen: Soft, non-tender, non-distended.
Extremities: Warm, well-perfused. No pitting edema bilaterally.
Neuro-
CN: 
     Pupils symmetric and responsive to light and accommodation
     Visual fields: Not directly assessed. Without obvious
deficits.
     EOM: intact
     Intact facial symmetry on eye closure and smile: intact and
no asymmetry
     Hearing bilaterally to rubbing fingers: intact
     Phonation: normal
     Head turning and shoulder shrug: normal bilaterally
     Tongue: midline, no ___

Motor: Strength Grossly Intact

Sensation: Intact 
Coordination: Intact 
Gait/Romberg: WNL 

Neuropsychiatric Examination:
  *Appearance: young man with brown hair, young facial features,
tall stature, wearing hospital gown
  Behavior: calm, appropriate, appearing withdrawn
  *Mood and Affect: "I just really wanted help"/dysthmic
  *Thought process: linear, no LOA 
  *Thought Content: no current SI/HI, feels he can ask for help
with safety on unit, denies AVH
  *Judgment and Insight: poor/improving
  Cognition:
    *Attention: DOWB ___
    *orientation: BI, Trump, ___, Location, City
    *Memory: intact to last three presidents
    *Fund of knowledge: can name ___ play by ___, average
    Calculations: correctly states 9 quarters in $2.25
    Abstraction: correctly interprets proverbs
    Visuospatial: not assessed
    *Speech: normal rate, rhythm, prosody, slightly quiet volume
    *Language: fluent ___ with no pharaphasic errors