Admission Exam 
PHYSICAL EXAM:
-VS: reviewed 
-General Appearance: pleasant, comfortable, no acute distress
-Eyes: PERLL, EOMI, no conjuctival injection, anicteric
-HENT: moist mucus membranes, atraumatic, normocephalic
-Respiratory: clear b/l, no wheeze 
-Cardiovascular: RRR, no murmur
-Gastrointestinal: nontender, nondistended, bowel sounds present
-GU: foley with leg bag draining clear urine. Scrotum
erythematous with edema and without ulceration. Right testicle
firm and enlarged without significant edema. 
-Musculoskeletal: no pedal edema, no joint swelling 
-Skin: no rash, ulceration, or jaundice noted
-Neuro: no focal neurological deficits, CN ___ grossly intact
-Psychiatric: appropriate mood and affect 

Discharge Exam:
___ 1532 Temp: 98.2 PO BP: 159/89 HR: 71 RR: 18 O2 sat: 97% 
O2 delivery: RA 
GENERAL: Alert and in no apparent distress
EYES: Anicteric, pupils equally round
ENT: Ears and nose without visible erythema, masses, or trauma.  
Oropharynx without visible lesion, erythema or exudate
CV: Heart regular, no murmur, no S3, no S4.  No JVD.
RESP: Lungs clear to auscultation with good air movement 
bilaterally.  Breathing is non-labored
GI: Abdomen soft, non-distended, non-tender to palpation.  Bowel 
sounds present. 
GU: Right scrotum is swelling and erythematous; non tender to 
palpation; Foley in place
MSK: Neck supple, moves all extremities, strength grossly full 
and symmetric bilaterally in all limbs
SKIN: No rashes or ulcerations noted
NEURO: Alert, oriented, face symmetric, gaze conjugate with 
EOMI, speech fluent, moves all limbs
PSYCH: pleasant, appropriate affect