ADMISSION PHYSICAL EXAMINATION:
VS: T:98  BP; 110/62   HR:82  RR: 18  Pain ___ O2sat 98% on RA

General: Middle-aged female in NAD. Thin. Appears stated age.
sweating. 
 HEENT: Normocephalic, atraumatic. PERRL, EOMI. 
 Back: No significant deformity.
 Lungs: CTA ___. No crackles, wheezes, or rhonchi.
 CV: RRR, no murmurs/rubs/gallops. 
 Abdomen: +BS, soft, nontender, nondistended.
 Extremities: No clubbing, cyanosis, or edema.
 Skin: No rashes, abrasions, scars, or lesions. 

Neurological:
 Cranial Nerves: II-XII grossly intact, no facial asymmetry, 
EOMI, clear speech
 Motor: Normal bulk and tone bilaterally. No abnormal movements,
no tremor.  
 Coordination: Normal on finger to nose test. 
 Sensation: Intact to light touch throughout. 
 Gait: Steady. Normal stance and posture. No truncal ataxia.

Cognition: 
 Wakefulness/alertness: awake and alert
 Attention: intact to interview
 Orientation: oriented to person, time, place, situation
 Memory: intact to recent and past history
 Fund of knowledge: consistent with education
 Speech: normal rate, volume, and tone
 Language: native ___ speaker, no paraphasic errors,
appropriate to conversation

Mental Status:
 Appearance: appears stated age, well-groomed, wearing hospital
gown and blanket, tattoos on both arms, poor dentition 
 Behavior: Calm, cooperative, appropriate eye contact, no
psychomotor agitation or retardation
 Mood and Affect: "depressed" / congruent with mood, dysphoric
 Thought Process: linear, coherent, goal-oriented. No LOA.
 Thought Content: endorses passive SI, denies intent or plan,
denies HI/AH/VH, no evidence of delusions or paranoia
 Judgment and Insight: poor/poor