ADMISSION
VITALS: Afebrile and vital signs stable (see eFlowsheet)
GENERAL: Alert and in no apparent distress, appeared to be
agitated.
EYES: Anicteric, pupils equally round
ENT: Ears and nose without visible erythema, masses, or trauma. 
Oropharynx without visible lesion, erythema or exudate
CV: Heart regular, + holosystolic murmur, no S3, no S4. no JVD.
RESP: Lungs clear to auscultation with good air movement
bilaterally.  Breathing is ___
GI: Abdomen soft, distended but ___ to palpation.  Bowel
sounds present.  
GU: No suprapubic fullness or tenderness to palpation
MSK: Neck supple, moves all extremities, strength grossly full
and symmetric bilaterally in all limbs
SKIN: No rashes or ulcerations noted, no splinter hemorrhage or
___ lesion. 
NEURO: Alert, oriented, face symmetric, gaze conjugate with 
EOMI,
speech fluent, moves all limbs, sensation to light touch grossly
intact throughout
PSYCH: pleasant, appropriate affect

DISCHARGE
VS: ___ 0730 Temp: 98.4 PO BP: 142/87 HR: 62 RR: 18 O2 sat:
99% O2 delivery: RA 
Gen - sitting up in bed, comfortable
Eyes - EOMI; sclera injected; PERRL; 
ENT - OP clear, MMM; 
Heart - RRR no mrg
Lungs - CTA bilaterally
Abd - soft nontender; normal bowel sounds 
Ext - no edema
Skin - no rashes
Vasc - 2+ DP/radial pulses
Neuro - AOx3, moving all extremities
Psych - appropriate