PHYSICAL EXAMINATION:
VS: BP=114/72, HR=92, T=98.8, RR=18, SaO2= 98%  on RA
* General: NAD. Well-nourished, well-developed
* HEENT: Normocephalic. PERRL, EOMI.
* Back: No significant deformity. No focal tenderness.
* Lungs: Clear to auscultation bilaterally. No crackles or 
wheezes.
* CV: Regular rate and rhythm. No murmurs/rubs/gallops. 
* Abdomen: Soft, nontender, nondistended
* Extremities: No clubbing, cyanosis, or edema.
* Skin: Warm and dry. No readily apparent rashes, scars. Pt has 
healing incisions on her upper thighs bilaterally, varying from 
1 in to 4 inches in length, about ___ on each leg. 

Neurological:
  *Cranial Nerves: CN II-XII intact 
  *Motor- Normal bulk and tone bilaterally. No abnormal 
movements, no tremor. Strength full power ___ throughout. No 
gross focal motor or sensory deficits, normal gait.
  *Coordination: Normal on finger-nose-finger.
  *Sensation: Intact to light touch, position sense intact.
  *Gait: Steady. No truncal ataxia. Normal stance and posture.

NEUROPSYCHIATRIC EXAMINATION:
* Appearance: NAD. Appears stated age. Well kept on examination. 
Tearful. 2 bottom lip piercings. Hair long. Fashionable glasses. 

* Behavior: Appropriate with good eye contact, cooperative with 
interview.
* Orientation: Oriented to self, location, and date.
* Mood: "anxious"
* Affect: dysthmic, nervous, congruent to stated mood.
* Thought Process: Logical and goal directed. No loosening of 
associations. No apparent disorganization.
* Thought Content: Denies current suicidal thoughts, plans, and 
actions. Denies HI. Free of any evidence of psychosis.
* Judgment: Poor.
* Insight: Poor.
* Speech: Spontaneous. Normal conversational volume, tone, rate, 
and prosody.