Admission EXAM
GENERAL: Alert and in no apparent distress, no cervical,
supraclavicular or axillary LAD
EYES: Anicteric, pupils equally round
ENT: Ears and nose without visible erythema, masses, or trauma. 
Oropharynx without visible lesion, erythema or exudate
CV: Heart regular, no murmur, no S3, no S4.  No JVD.
RESP: Lungs clear to auscultation with good air movement
bilaterally.  Breathing is non-labored
GI: Abdomen soft, non-distended, non-tender to palpation.  Bowel
sounds present. No hepatomegaly or splenomegaly.
GU: No suprapubic fullness or tenderness to palpation
MSK: Neck supple, moves all extremities, strength grossly full
and symmetric bilaterally in all limbs
SKIN: Non-tender, non-pruritic warm erythematous patch in
4cm-wide band around LUE. No spider angiomas or other stigmata 
of
liver dz.
NEURO: Alert, oriented, face symmetric, speech fluent, moves all
limbs, sensation to light touch grossly intact throughout
PSYCH: pleasant, appropriate affect

Discharge Exam:
Vitals: temp 98.1; BP 132/85; HR 68; RR 18; O2 99% RA
Gen: young woman laying comfortably in bed with mother nearby, 
NAD
HEENT: EOMI, ___, MMM
Lungs: CTAB
Heart: RRR, S1 and S2
Abdomen: soft, NT, ND, +BS
Ext: warm, well perfused, no ___ edema
Skin: non-pruritic, warm, non-blanching, erythematous patch in 
4cm-wide band around LUE, somewhat rough on palpitation
Psych: normal mood and affect
Neuro: AOx3, no focal deficits