Vital Signs: 98.2 106/53 65 20 96% RA 
GEN: NAD, well-appearing, somnolent and sleeping while talking, 
otherwise alert
EYES: PERRL, EOMI, conjunctiva clear, anicteric, R eye 
incomplete closure
ENT: moist mucous membranes, no exudates 
NECK: supple, mild meningismus 
CV: RRR s1s2 nl, no m/r/g
PULM: CTA, no r/r/w 
GI: normal BS, NT/ND, no HSM  
EXT: warm, no c/c/e, no clear e/o synovitis
SKIN: no rashes 
NEURO: alert, oriented x 3, answers ? appropriately, follows 
commands, R facial LMN weakness, asymmetric labial fold 
PSYCH: appropriate
ACCESS: PIV
FOLEY: absent
. 
Discharge Exam: 
97.6 ___
Gen: NAD, lying in bed comfortably, speaking full sentences
without accessory muscle use
Eyes: EOMI, sclerae anicteric, R eye not blinking
ENT: MMM, OP clear, obvious R sided facial droop with forehead
involvement
Cardiovasc: RRR, no MRG, full pulses, no edema  
Resp: normal effort, no accessory muscle use, lungs CTA ___.
GI: soft, NT, ND, BS+
MSK: No significant kyphosis. No palpable synovitis.
Skin: No visible rash. No jaundice. 
Neuro: AAOx3. Facial droop as above. Gait narrow based and 
steady, full strength except R droop.  
Psych: Full range of affect
GU: no foley, otherwise deferred