ADMISSION Physical Exam:
.
VS:  Afebrile and vital signs stable (reviewed in bedside 
record)
General Appearance: pleasant, comfortable, no acute distress
Eyes: Dry mms
Respiratory: CTA b/l with good air movement throughout
Cardiovascular: RR, S1 and S2 wnl, no murmurs, rubs or gallops
Gastrointestinal: nd, +b/s, soft, nt, no masses or HSM
Extremities: no cyanosis, clubbing or edema
Skin: warm, no rashes/no jaundice/no skin ulcerations noted
Neurological: Alert, oriented to self, time, date, reason for
hospitalization.  Cn II-XII intact.  ___ strength throughout.  
No
sensory deficits to light touch appreciated.  No pass-pointing 
on
finger to nose.  2+DTR's-patellar and biceps. No asterixis, no
pronator drift, fluent speech.
Psychiatric: pleasant, appropriate affect
GU: no catheter in place

DISCHARGE PHYSICAL Exam:
98.9  125/68  P 79  R 16  97% on RA
Gen: NAD, lying in bed, comfortable, alert and talkative. Eating 
breakfast.
Eyes: EOMI, sclerae anicteric  
ENT: MMM, OP clear
Cardiovasc: RRR, no MRG, full pulses, no edema  
Resp: normal effort, no accessory muscle use, lungs CTA ___.
GI: soft, NT, ND, BS+, no HSM
MSK: No significant kyphosis. No palpable synovitis.
Skin: No visible rash. No jaundice. his fingernails are normal 
except for one on his L hand which he says he injured a while 
back
Neuro: AAOx3. PERRL No facial droop.
Psych: Full range of affect