ADMISSION PHYSICAL EXAM:
Vitals:  ___ 0445 Temp: 97.7 PO BP: 172/80 HR: 60 RR: 18 O2
sat: 99% O2 delivery: RA 
GENERAL: sitting in bed, appears comfortable but tired, NAD
EYES: PERRLA, icteric
HEENT:  dry MM, op clear
NECK:  supple, normal ROM
LUNGS:  CTA b/l, no wheezes/rales/rhonchi, normal RR
CV:  RRR normal distal perfusion, no edema
ABD: soft, non distended, has small hematoma at Lovenox 
injection
sites
GENITOURINARY: no foley or suprapubic tenderness
EXT:  warm, no deformity, normal muscle bulk
SKIN:  warm, dry, no rash
NEURO:  AOx3 fluent speech
ACCESS: PORT dressing c/d/i

DISCHARGE PHYSICAL EXAM:
VITALS: 98.2 PO135/___%RA
GEN: NAD
EYE: EOMI, sclerae icteric
ENT: MMM, OP clear 
NECK: No LAD, no JVD
CARDIAC: RRR, no M/R/G
PULM: normal effort, no accessory muscle use, CTAB
GI: soft, ND. Hyperactive bowel sounds. Mild TTP in epigastrium
MSK: No visible joint effusions or deformities.
DERM: No visible rash. No jaundice.
NEURO: AAOx3. No facial droop, moving all extremities. no 
asterixis
PSYCH: Full range of affect
EXTREMITIES: WWP, no edema