PHYSICAL EXAM ON ADMISSION:
VS: T=98.1, BP=140/80, HR=77, 20, 99% RA
GENERAL: Well-appearing man in NAD, comfortable, appropriate.
HEENT: NC/AT, PERRLA, EOMI, sclerae anicteric, MMM, OP clear.
NECK: Supple, no JVD.
HEART: RRR, no MRG, nl S1-S2.
LUNGS: CTA bilat, no r/rh/wh, good air movement, resp unlabored.
ABDOMEN: Soft/NT/ND, no rebound/guarding.
EXTREMITIES: WWP, no c/c/e.
SKIN: Left lower extremity surgical site surrounded by a ring of 
warmth and erythema that was demarcated with a marker.
NEURO: Awake, A&Ox3, CNs II-XII grossly intact, muscle strength 
___ throughout, sensation grossly intact throughout.
.
PHYSICAL EXAM ON DISCHARGE:
VS: T 97.0, BP 143/86, HR 76, RR 18, SpO2 100% on RA
Gen: NAD. Alert and oriented x3. Pleasant and cooperative. 
Appears well and younger than stated age. Ambulating in room.
HEENT: NCAT. PERRL, EOMI, anicteric sclera. MMM, OP benign.
Neck: Supple. JVP not elevated. No cervical lymphadenopathy.
CV: RRR. Normal S1, S2. No M/R/G appreciated.
Chest: Respiration unlabored, no accessory muscle use. Lungs 
CTAB. No wheezes, rhonchi, or rales.
Abd: BS present. Soft, NT, ND. No HSM detected.
Ext: WWP, no cyanosis or clubbing. No ___ edema. Digital cap 
refill <2 sec. Distal pulses radial 2+, DP 2+, ___ 2+.
Skin: Skin ulcer 2 cm in diameter on left lateral shin with some 
mild surrounding erythema. No tenderness or fluctuance. The 
involved area is well within the markings from admission.
Neuro: CN II-XII grossly intact. Moving all four limbs.