PHYSICAL EXAMINATION:
 VS: T:98.1 , BP:114/78 , HR:92 , R:16 , O2 sat: 99% on RA

General: young  female, tearful. Well-nourished, well-developed.
Appears stated age.
 HEENT: Normocephalic, palpable lump on right occipital region.
PERRL, EOMI. 
 Back: No significant deformity.
 Lungs: CTA ___. No crackles, wheezes, or rhonchi.
 CV: RRR, no murmurs/rubs/gallops. 
 Abdomen: +BS, soft, nontender, nondistended. 
 Extremities: No clubbing, cyanosis, or edema.
 Skin: several bruises on left flank. 

Neurological:
  Cranial Nerves: II- XII grossly intact
  Motor: strength and tone symmetrical and normal in all 4
extremities, no abnormal movements, no tremor. 
 Sensation: Intact to light touch throughout. 
 Gait: Steady. Normal stance and posture. No truncal ataxia.
 
Cognition: 
   Wakefulness/alertness: alert and engaged 
   *Attention: intact to interview
   *Orientation: oriented x3 (self, location and date) 
   *Memory:  Intact to recent and remote events
   *Fund of knowledge:  appropriate for level of education - 
able to identify current events in the news  
   *Speech: normal tone, volume, rate and prosody
   *Language: fluent ___ speaker without paraphasic errors.

Mental Status:
 Appearance: malodorous, tearful, wearing hospital gown
 Behavior: Labile, anxious-appearing, tearful, tapping foot
 Mood and Affect: "I'm fine" / non-congruent, tearful, labile
 Thought Process: linear, coherent, goal-oriented. Ruminative on 
discharge planning
 Thought Content: denies SI/HI/AH/VH, no evidence of delusions 
or paranoia
 Judgment and Insight: poor/poor