==========================================
PREOPERATIVE PHYSICAL EXAM
==========================================
GENERAL:  No acute distress, well developed, well nourished,
appears stated age.
HEENT: NC/AT, sclera anicteric
SKIN:  Warm and dry.
NEUROLOGIC:  Alert and oriented x 4.
NECK: Supple no mass
LYMPHATICS:  No palpable supraclavicular, cervical, or
inguinofemoral lymphadenopathy.
LUNGS:  Clear to auscultation bilaterally.
HEART:  Regular rate and rhythm.
BACK: No spinal or cva tenderness.
ABDOMEN:  Soft, nontender, nondistended, normoactive bowel
sounds, without palpable masses or hepatosplenomegaly.
EXTREMITIES:  Nontender, no edema bilaterally.
PELVIC: 
External female genitalia: normal
Vagina: no lesions
Cervix: small, anterior, no lesions, not expanded
Uterus: difficult to appreciate d/t habitus
Adnexa: no palpable masses
RECTAL:  normal tone, smooth rectovaginal septum, no rectal
impingement, and otherwise confirms the pelvic exam above.

==========================================
PHYSICAL EXAM ON DISCHARGE:
==========================================
Vitals: Afebrile, vitals stable
Gen:No acute distress
CV: regular rate and rhythm
Pulm: clear to auscultation bilaterally
Abd: soft, appropriately tender, nondistended, incision 
clean/dry/intact, no rebound/guarding
___: nontender, nonedematous