VS: Temp: 98.5 °F (36.9 °C), Pulse: 115, RR: 16, BP: 121/85,
MAP: 97.0 mm Hg, O2 sat: 100

* General: in NAD
* HEENT: Normocephalic. Atraumatic. Oropharynx clear.
* Neck: No adenopathy or thyromegaly.
* Lungs: CTAB
* CV: RRR with normal S1 and S2, no m/r/g
* Abdomen: + BS, soft, NT, ND
* Extremities: No clubbing, cyanosis, or edema.
* Skin: Warm and dry, no rashes, scars, or lesions.

*Neurological:  
  Station and gait: narrow based, steady, wnl
  Tone and strength: grossly intact, spontaneously moves all 
extremities
  Cranial nerves: CN II-XII grossly intact
  Abnormal movements: no tremor or abnormal posturing

*Cognition: 
   Wakefulness/alertness: awake and alert
   Attention: can do MOYB
   Orientation: oriented to person, time, place, situation
   Memory: ___ registration, ___ recall after 5 ___ 
grossly intact
   Fund of knowledge: consistent with education; intact to last 
2 presidents (Could not recall ___
   Calculations: $2.75 = "11 quarters"
    
*Mental Status:
   Appearance: No apparent distress, appears stated age, well 
groomed   Behavior: Cooperative, engaged, appropriate eye 
contact
   Mood and Affect: "Nervous" / Restricted range, appropriate to 
situation, congruent with mood
   Thought process: linear, coherent, goal-oriented, no loose 
associations.
   Thought Content: Currently denies SI or paranoia; No AH/VH
   Judgment and Insight: fair/fair